# # # # # # # # # # # # # # # # # # # # # # # # # # # # # # # # # # # # # # # # # # # # # # # # # # # # # # # # # # # # # 
# O . . . . . . . # . . . . . # . . # . . . . . # . . . . . . . . . . . # . . . . . . . . . . . . . . . . . . . . . . . # 
# . . # # # # # # # . . # . . # . . # . . # # # # . . # # # # # # # # # # # # # # # # . . # # # # # # # . . # # # # # # # 
# . . # . . . . . # . . # . . # . . # . . # . . # . . . . . . . . . . . . . . # . . # . . . . . . . . # . . . . . . . . # 
# . . # . . # # # # . . # # # # . . # . . # . . # . . # # # # # # # # # # # # # . . # # # # # # # . . # # # # . . # . . # 
# . . . . . . . . # . . . . . . . . . . . . . . . . . . . . # . . . . . . . . . . . . . . . . . # . . # . . # . . # . . # 
# # # # . . # . . # # # # # # # . . # . . # # # # # # # # # # # # # # # # # # # . . # # # # . . # # # # . . # . . # # # # 
# . . . . . # . . # . . . . . # . . # . . . . . # . . . . . . . . . . . # . . . . . # . . . . . # . . . . . . . . . . . # 
# # # # # # # . . # . . # # # # . . # # # # # # # . . # # # # . . # # # # . . # # # # # # # . . # . . # # # # . . # # # # 
# . . . . . . . . # . . . . . . . . # . . . . . . . . # . . # . . . . . # . . # . . . . . # . . . . . . . . # . . . . . # 
# . . # . . # . . # # # # . . # . . # . . # . . # # # # . . # . . # . . # # # # . . # # # # . . # . . # # # # . . # # # # 
# . . # . . # . . # . . . . . # . . . . . # . . . . . . . . # . . # . . . . . . . . . . . . . . # . . . . . # . . . . . # 
# . . # # # # # # # # # # . . # . . # . . # # # # # # # . . # # # # # # # # # # . . # # # # . . # . . # # # # # # # # # # 
# . . . . . . . . # . . . . . # . . # . . # . . . . . # . . # . . # . . . . . # . . # . . . . . # . . . . . . . . . . . # 
# . . # . . # # # # # # # # # # . . # . . # . . # # # # # # # . . # # # # . . # . . # # # # . . # # # # . . # . . # # # # 
# . . # . . . . . . . . . . . . . . # . . # . . # . . . . . . . . . . . . . . . . . # . . . . . # . . . . . # . . . . . # 
# # # # # # # # # # # # # . . # # # # # # # . . # # # # . . # . . # # # # . . # . . # # # # . . # . . # # # # # # # # # # 
# . . . . . . . . . . . # . . . . . # . . # . . # . . # . . # . . # . . . . . # . . # . . . . . # . . . . . # . . . . . # 
# # # # . . # . . # # # # . . # . . # . . # . . # . . # . . # . . # . . # # # # # # # . . # # # # . . # . . # . . # # # # 
# . . . . . # . . . . . . . . # . . . . . . . . . . . # . . # . . # . . # . . . . . . . . # . . . . . # . . . . . . . . # 
# # # # # # # # # # # # # # # # # # # # # # # # # # # # # # # # # # # # # # # # # # # # # # # # # # # # # # # # # # # # # 