# # # # # # # # # # # # # # # # #
# . . . # . . . . . . # . # . . #
# # # # # . # # # . . . . # . # #
# . . . . . . . . . # . . . . . #
# . # # # . # . # . # . # . # . #
# . # . # . # . # . # . # . # . #
# . # . # . # . # . . # # . # . .
# . # . . . # . # # . # . # . . .
# . . . # # # . . # . . . . . # .
# . . . . . . . # # . # # . . . .
# # # # . # . . . # . # . . # . .
# . . . . # . # . . . # # . # . .
# . # # . # . # O # . . . . . . .
# # # # # # # # # # # # # # # # .
