 # # # # # # # # # # # # # # # # # # # 
 # . . . . . . . . . . . . . . . . . #
 # . # # # # # # # # # # # # # # # . #
 # . # . . . . . . . . . . . . . # . #
 # . # . # # # # # # # # # # # . # . #
 # . # . # O . . . . . . . . . . # . #
 # . # . # # # # # # # # # # # # # . #
 # . # . . . . . . . . . . . . . . . # 
 # # # # # # # # # # # # # # # # # # # 